11111111111
1P000C00E01
11111111111
