1111111111111111
1C0000000000C001
10000P0000001001
10C0000000000001
10000001C00000E1
1111111111111111
